###########################################################
#                                                         #
#                                           *             #
#                                                         #
######################               ######################
#                        #########                        #
#            *                      ***********           #
#                        #########                        #
######################               ######################
#                                                         #
#                                                         #
#                                                         #
###########################################################
